1 1 1 1 1 7 1 7 7 7 7 7 7 7 7 1 1 1 1 1 1 1 1 1 1 1 1 1 1 1 1 1 1 1 1 1 1 1 1 1
1 0 0 0 1 0 7 0 0 0 0 0 7 0 7 1 0 0 0 0 0 0 2 0 0 0 7 0 0 0 0 7 0 0 0 0 0 0 0 1
1 0 S 0 1 0 7 0 0 7 0 0 0 0 11 1 0 0 0 0 0 0 0 0 0 0 0 0 7 0 0 0 0 0 7 0 0 0 0 1
1 0 1 0 1 0 7 0 7 7 0 7 7 0 7 1 0 0 0 0 0 0 2 0 0 7 0 0 7 0 0 0 7 0 7 0 0 7 0 1
1 0 0 0 1 0 7 0 0 0 0 0 0 0 7 1 0 0 0 0 0 0 1 7 0 7 0 0 0 0 7 7 7 0 0 0 0 7 0 1
1 1 0 1 1 0 0 2 1 3 0 2 1 3 1 1 0 0 0 0 0 0 1 0 0 7 7 7 0 0 7 0 0 0 0 0 0 7 7 1
4 0 0 0 4 4 4 0 0 0 0 0 0 0 2 1 0 0 0 0 0 0 1 7 7 0 0 0 0 0 7 0 0 0 7 7 0 0 0 1
4 0 0 0 0 0 0 0 0 0 0 0 0 0 5 5 0 0 0 0 0 0 1 7 0 0 0 7 0 0 7 7 0 7 0 0 0 0 0 1
4 0 4 4 4 4 4 0 0 0 0 0 0 0 2 1 0 0 0 0 0 0 1 7 0 7 0 7 0 0 7 7 0 0 0 0 7 0 0 1
4 0 4 6 4 6 4 2 1 3 5 2 1 3 1 1 1 1 1 1 1 1 1 7 7 7 0 7 7 7 0 7 7 7 7 7 7 7 7 1
4 0 0 0 0 0 6 0 0 0 0 0 0 0 0 0 0 0 0 0 0 0 0 0 0 1 0 1 4 4 4 4 4 4 4 4 4 4 4 1
4 0 4 0 0 0 6 0 0 0 0 0 0 0 0 0 0 0 0 0 0 0 0 0 0 2 0 2 4 0 0 0 0 0 0 1 0 0 0 4
4 4 4 6 4 6 4 0 0 0 0 0 0 0 0 0 0 0 0 0 0 0 0 0 0 1 0 1 4 0 0 0 0 0 0 1 0 0 0 4
1 0 0 0 0 0 0 0 0 0 0 0 0 0 0 0 0 0 0 0 0 0 0 0 0 3 0 3 4 0 0 0 4 4 4 4 0 0 0 4
1 0 0 0 0 0 0 0 0 0 0 0 0 0 0 0 0 0 0 0 0 0 0 0 0 1 0 1 4 0 0 0 0 0 0 4 0 0 0 4
1 0 0 0 0 0 0 0 0 0 0 0 0 0 0 0 0 0 0 0 0 0 0 0 0 2 0 2 4 0 0 0 0 0 0 6 0 0 0 6
1 0 0 0 0 0 0 0 0 0 0 0 0 0 0 0 0 0 0 0 0 0 0 0 0 4 0 6 4 6 4 6 4 6 0 4 0 0 0 4
1 0 0 0 0 0 0 0 0 0 0 0 0 0 0 0 0 0 0 0 0 0 0 0 0 6 0 0 0 0 0 0 0 0 0 6 0 0 0 6
1 0 0 0 0 0 0 0 0 0 0 0 0 0 0 0 0 0 0 0 0 0 0 0 0 4 0 0 0 0 0 0 0 0 0 4 0 0 0 4
1 0 0 0 0 0 0 0 0 0 0 0 0 0 0 0 0 0 0 0 0 0 0 0 0 6 0 0 0 0 0 0 0 0 0 6 0 0 0 4
1 1 1 1 1 1 1 1 1 1 1 1 1 1 1 1 1 1 1 1 1 1 1 1 1 4 4 6 4 6 4 6 4 6 4 4 4 4 4 5
